0 10
6 6
YYYY YYYY YYYY YYYY YYYY YYYY
YYYY RRRR YYYY RRRR RRRR YYYY
YYYY RRRR RRRR RRRR RRRR YYYY
YYYY RRRR RRRR RRRR RRRR YYYY
YYYY RRRR RRRR RRRR RRRR YYYY
YYYY YYYY YYYY YYYY YYYY YYYY
Ruby 2 1
Diamond 1 3
Door 1 4
Player 1 1 RIGHT